############################################
#******************************************#
#******************************************#
#******************************************#
#******************************************#
#******************************************#
#******************************************#
#******************************************#
#                                          #
#                                          #
#                                          #
#                                          #
#                                          #
#                                          #
#                                          #
#                                          #
#                                          #
#                                          #
#                                          #
############################################