############################################
#                                          #
#                    *                     #
#                                          #
#                                          #
#                                          #
#                                          #
#                                          #
#                                          #
#                                          #
#                                          #
#                                          #
#                                          #
#                                          #
#                                          #
#                                          #
#                                          #
#                                          #
#                                          #
############################################